#       ##  ##
#  ##    ###
##  #   #  #
###       #
##         #