##############
# H #  ####  #
# ####23##  #
# 12# 2##  #
###1# ##  #
#     1   #
#########