#### #
#    #
     #
# #  #
#    #
## ##